CatchFish=물고기잡기
CatchInsect=곤충잡기
CatchFishContinuously=연속물고기잡기
FillFishList=물고기도감완성
FillInsectList=곤충도감완성
ShootDownBalloon=풍선쏘기
PlantFlowerSeed=꽃씨심기
PlantFruit=과일심기
PlantTreeSeedling=나무묘목심기
BuyKabu=무구입
HowmuchSellKabu=무판매가격
HowmuchBuyItem=아이템구매가격
BuyItemRcm=아이템구매추천
SellItemRcm=아이템판매추천
RemakeFurniture=가구리메이크
FillCatalog=카탈로그완성
BuyItemCatalog=카탈로그아이템구매
GotoTotakekeShow=토타케케공연참석
VisitAnotherIsland=다른섬방문
InviteFriend=친구초대
DayPlayed=게임플레이일수
WaterPlant=식물물주기
BeStungbyWasp=말벌에쏘임
CatchSeminonukegara=세미노누케가라잡기
CatchNomi=노미잡기
BeStungbyPoisonousInsect=독곤충에쏘임
FillReactionList=반응목록완성
CatchTrash=쓰레기잡기
PayImmigrationCost=이주비지불
RepayLoan=대출상환
UseMydesign=내디자인사용
UseMydesignPRO=내디자인PRO사용
SellWeed=잡초판매
CollectGoldTool=황금도구수집
GetSRankonHHA=HHA에서S랭크획득
AttendFishingConvention=낚시대회참가
AttendInsectConvention=곤충채집대회참가
HelpGul=굴도움
HelpGst=거스트도움
MakePerfectSnowball=완벽한눈덩이만들기
ReachMyBirthday=내생일도달
CelebrateVillagersBithday=주민생일축하
AttendCountdownParty=카운트다운파티참석
BreakTool=도구부수기
SendLetter=편지보내기
MakePitfall=함정만들기
FallintoPitfall=함정에빠지기
ImmigratetoIsland=섬으로이주
BeFriendwithVillager=주민과친구되기
FillRecipeList=레시피목록완성
BootPhone=폰부팅
StrikeRock8Times=바위8번치기
AchieveAppQuest=앱퀘스트달성
AchieveVillagersQuest=주민퀘스트달성
DigBell=벨파기
DigFossil=화석파기
JudgeFossil=화석감정
DigShell=조개파기
PutFurnitureOutside=가구밖에놓기
StrikeWood=나무치기
GreetAllVillager=모든주민인사
SellShell=조개판매
SellFruit=과일판매
CatchBeeContinuously=연속벌잡기
DIYTool=DIY도구
DIYFurniture=DIY가구
TakePicture=사진찍기
BootPhoneBeginner=초보자폰부팅
HouseStorageItem=집보관아이템
PlaceFurnitureMyHouse=내집에가구놓기
FallFurnitureLeaf=가구잎떨어뜨리기
DropPresentinWater=물에선물떨어뜨리기
ReformMyHome=내집리폼
ExtendMyHome=내집확장
PostMessageBoard=게시판글쓰기
UseCloset=옷장사용
PrayShootingStar=별똥별소원빌기
ChangeSymbol=심볼변경
UpdatePassport=여권업데이트
ModifyIsland=섬수정
BuildFence=울타리짓기
DonateFake=가짜기부
BuyatTsunekichiShop=츠네키치상점에서구매
PlantBushSeedling=관목묘목심기
FillSeafoodList=해산물도감완성
GiveScallopsToSeo=세오에게가리비주기
CatchSeafood=해산물잡기
PrologueNpcHintCount=프롤로그NPC힌트횟수
TotakekeLiveCount=토타케케라이브횟수
JohnnyQuestStartFlag=조니퀘스트시작플래그
JohnnyQuestFinishFlag=조니퀘스트완료플래그
JonnyTalkCount=조니대화횟수
HasPlayedTreasureHunt=보물찾기플레이여부
ShizueCmnExplanationTowntune=시즈에마을노래설명
ShizueCmnExplanationTownflag=시즈에마을기설명
ShizueCmnExplanationComplaint=시즈에불만설명
FutaTalkedWhenAsleep=후타잠들었을때대화
FutaExplanationDonationComp=후타기부완료설명
FutaTalkedInMuseumToday=후타오늘박물관에서대화
FutaHeardCommentary=후타해설들음
FutaReadyForMuseum=후타박물관준비
FutaReadyForMuseumToday=후타오늘박물관준비
KaburibaTalkTodayFlag=카부리바오늘대화플래그
KaburibaTalkBeforeFlag=카부리바이전대화플래그
KaburibaBuyKabuTodayFlag=카부리바오늘무구매플래그
KinuyoTalkBoforeFlag=키누요이전대화플래그
KinuyoTalkTodayFlag=키누요오늘대화플래그
SkkTalkBeforeFlag=스크이전대화플래그
ReijiTalkBeforeFlag=레이지이전대화플래그
RollanTalkTodayFlag=롤란오늘대화플래그
RollanBuyLargeCount=롤란대형구매횟수
RollanBuyMediumCount=롤란중형구매횟수
RollanBuySmallCount=롤란소형구매횟수
RcmTalkBeforeFlag=알크이전대화플래그
RcmTookReqMarket=알크시장요청수락
RcmDeclinedMarketReq=알크시장요청거절
DoneCharacterCreation=캐릭터생성완료
RcmNoTurnipSellToday=알크오늘무판매안함
ValidatePlayerSaveFlag=플레이어세이브검증플래그
MakeVillagePlayerFlag=마을플레이어생성플래그
PrologueDone1stTalkAtPlaza=프롤로그광장첫대화완료
HighAndLowPlayed=하이앤로우플레이
HappyHomeMission1=해피홈미션1
OccurrenceCoinStone=코인스톤발생
HappyHomeMission2=해피홈미션2
SeoRejectFlag=세오거절플래그
HappyHomeMission3=해피홈미션3
CatchFishFesCount=낚시축제잡기횟수
CatchInsectFesCount=곤충축제잡기횟수
PlayerPocketUIEnable=플레이어주머니UI활성화
PlayerMainUImenuEnable=플레이어메인UI메뉴활성화
Prologue4AfterBuiltPcTent=프롤로그4PC텐트건설후
RcoHearedWhatShouldIAsk=알코무엇을물어야할지들음
Prologue4OwlNoMuseum=프롤로그4부엉이박물관없음
Prologue4OwlGetTent=프롤로그4부엉이텐트획득
Prologue4OwlBuiltMuseum=프롤로그4부엉이박물관건설
Prologue4RcmNoShop=프롤로그4알크상점없음
Prologue4RcmGetTent=프롤로그4알크텐트획득
Prologue4RcmBuiltShop=프롤로그4알크상점건설
Prologue4HaNoTent=프롤로그4하텐트없음
Prologue4HaGetTent=프롤로그4하텐트획득
Prologue4HaBuiltTent=프롤로그4하텐트건설
Prologue4AnNoTent=프롤로그4안텐트없음
Prologue4AnGetTent=프롤로그4안텐트획득
Prologue4AnBuiltTent=프롤로그4안텐트건설
BirthdayNGavePresentFlag=생일N선물줌플래그
BirthdayPCandleFlag=생일P캔들플래그
BirthdayPNotPresentFlag=생일P선물안줌플래그
SickQuestFirst=병퀘스트첫번째
TotakekeTalkBeforeFlag=토타케케이전대화플래그
JohnnyTalkBeforeFlag=조니이전대화플래그
KotonoTalkBeforeFlag=코토노이전대화플래그
RollanTalkBeforeFlag=롤란이전대화플래그
TunekichiTalkBefore=츠네키치이전대화
KotonoQuestCount=코토노퀘스트횟수
KotonoQuestStartFlag=코토노퀘스트시작플래그
KotonoQuestClearFlag=코토노퀘스트클리어플래그
KotonoQuestRefuseFlag=코토노퀘스트거절플래그
MainmenuEncyclopedia=메인메뉴도감
MainmenuMap=메인메뉴지도
MainmenuMydesign=메인메뉴내디자인
MainmenuBank=메인메뉴은행
RcmTalked1P1stday=알크1P첫날대화
HappyHomeMission4=해피홈미션4
RcoHeardDetailDIYtrial=알코상세DIY시연들음
SzaTaled1stTime=사자첫번째대화
HappyHomeMission5=해피홈미션5
HappyHomeMission6=해피홈미션6
OdekakeTutorial=외출튜토리얼
OdekakeTutorialKeyword=외출튜토리얼키워드
RcoGotWorkingwear=알코작업복획득
RcoHeardWorkExplain1=알코작업설명1들음
RcoHeardWorkExplain2=알코작업설명2들음
RcoFinishMakingAxe=알코도끼만들기완료
OdekakeFirstTalk=외출첫대화
OdekakeFirstOpenGate=외출첫게이트열기
SzaGotDiyRecipe001=사자DIY레시피001획득
OwlGotDiyRecipe001=부엉이DIY레시피001획득
TownNewsHeard1st=마을소식첫번째들음
GyroidPlazaTalk1st=가이로이드광장첫대화
PlayerLoanRepaying=플레이어대출상환중
PlayerLoanFinish1st=플레이어대출첫번째완료
RcoHeardRemodel1=알코리모델1들음
UsedCoinStone=코인스톤사용
OwlFinished1stTalk=부엉이첫대화완료
OwlTalkDuringConst1=부엉이공사중대화1
OwlDonationDone=부엉이기부완료
Owl1stTalkMuseum1=부엉이박물관1첫대화
EnableEmoticonUI=이모티콘UI활성화
RcoDoneDIYmyself=알코직접DIY완료
RcoOrderedHouseBuilt=알코집건설주문
RcmHeardAboutRenual=알크리뉴얼들음
RcmHeardAboutNewOpen1=알크새오픈1들음
RcmHeardAboutNewOpen2=알크새오픈2들음
ChmTalkRuleFirst=챔규칙첫대화
ChmQuestFinish=챔퀘스트완료
ChmTalkPoint_BeforeEv=챔대화포인트_이벤트전
ChmTalkFirst_EvQuestFinish=챔첫대화_이벤트퀘스트완료
ChmTalkFirst_AfterEv=챔첫대화_이벤트후
RcoGotDonationRewardFlower=알코기부보상꽃획득
TownNewsHeardTownHallOpenFlag=마을소식타운홀오픈플래그
TownNewsHeardShopOpen1Flag=마을소식상점1오픈플래그
TownNewsHeardShopOpen2Flag=마을소식상점2오픈플래그
TownNewsHeardMuseumOpenFlag=마을소식박물관오픈플래그
MarvelAtCockroarchToday=오늘바퀴벌레감탄
GstTalkBefore=거스트이전대화
GstQuestStartFlag=거스트퀘스트시작플래그
GstQuestClearFlag=거스트퀘스트클리어플래그
GstQuestBreakFlag=거스트퀘스트중단플래그
MainmenuRecipe=메인메뉴레시피
PurchaseBoxUseTodayFlag=구매상자오늘사용플래그
TownNewsHeardEventOpen=마을소식이벤트오픈들음
PostHasNewMessage=게시판새메시지있음
EnablePcTownDecoration=PC마을장식활성화
KaburibaConditionFlag=카부리바상태플래그
SzaHeardSonkatsuExplain=사자손카츠설명들음
SzaHeardMuraokoshiExplain=사자무라오코시설명들음
SzaHeardAboutHousingKit=사자주택키트들음
SeoFirstFlag=세오첫번째플래그
FoxTalkTodayFlag=여우오늘대화플래그
FoxBuyTodayFlag=여우오늘구매플래그
FoxBuyArtTodayFlag=여우오늘미술품구매플래그
TownNewsHeardEventSpaceOpenFlag=마을소식이벤트공간오픈플래그
PcDidNotKnowKK=PC가KK를몰랐음
RcoAfterHouseRemodel=알코집리모델후
HeardAboutBuildingTownOffice=타운오피스건설들음
RcoFenceShoppingExplain=알코울타리쇼핑설명
Ttl1stmet=토탈첫만남
PcTownmakeLv=PC마을만들기레벨
PcUpgradeTownmakeToday=PC오늘마을만들기업그레이드
PcHousingLoanFinish=PC주택대출완료
RcoGetTvForCongratsHouse=알코집축하TV획득
RcoItemFullForTv=알코TV용아이템가득
PlayerEnableEating=플레이어식사활성화
PlayerStungByBee=플레이어벌에쏘임
GetEmoticonTodayFlag=오늘이모티콘획득플래그
BevTalkRuleFirst=베브규칙첫대화
BevQuestFinish=베브퀘스트완료
BevTalkPoint_BeforeEv=베브대화포인트_이벤트전
BevTalkFirst_EvQuestFinish=베브첫대화_이벤트퀘스트완료
BevTalkFirst_AfterEv=베브첫대화_이벤트후
TutorialFinishAndPast1day=튜토리얼완료후1일경과
HasGottenToolChangeStick=도구변경스틱획득여부
GetBirthdayTable=생일테이블획득
GetBirthdayCandle=생일캔들획득
GetBirthdayHat=생일모자획득
GetBirthdayBoard=생일보드획득
GetBirthdaySunglasses=생일선글라스획득
MainUiClockEnable=메인UI시계활성화
PrologueAfterBuiltTentTalk=프롤로그텐트건설후대화
PrologueForCampfire1=프롤로그캠프파이어1
PlayerPickupEnable=플레이어줍기활성화
HaveTownFruit4CampFire=캠프파이어용마을과일보유
PrologueForCampfire2=프롤로그캠프파이어2
SzaTalkBeforeCountdown=사자카운트다운전대화
SzaTalkAfterCountdown=사자카운트다운후대화
SzaGotNewYearHat=사자새해모자획득
SzaGotCracker=사자크래커획득
PrologueStartedCampfire=프롤로그캠프파이어시작
AllowPcTentEntering=PC텐트입장허용
TkkTalkToday=토타케케오늘대화
TkkLiveToday=토타케케오늘라이브
PcMaingameStart=PC메인게임시작
TkkGetMusicToday=토타케케오늘음악획득
MoveNpcTradeSkipCount=이동NPC거래건너뛰기횟수
RcoTalked1stAfterPrologue=알코프롤로그후첫대화
RcmTalked1stAfterPrologue=알크프롤로그후첫대화
RcoTentAdviceCanceled=알코텐트조언취소
RcoHeardAboutMyhome=알코내집들음
PlayerFirstShootDownBalloon=플레이어첫풍선쏘기
PrologueFinishTkkDream=프롤로그토타케케꿈완료
RcoPaid1stCharge=알코첫번째요금지불
RcoTentEnableDIYtrial=알코텐트DIY시연활성화
RcoDIYtrialOngoing=알코DIY시연진행중
RcoDIYtrialGetMaterial=알코DIY시연재료획득
RcoTentDonation=알코텐트기부
RcoTentDonatinDeclined=알코텐트기부거절
EnableBuildMuseumTent=박물관텐트건설활성화
RcoTookRequestMuseum=알코박물관요청수락
DecidedMuseumTentPlace=박물관텐트위치결정
RcoDeclinedMuseumReq=알코박물관요청거절
RcmDeclinedQuestReq=알크퀘스트요청거절
RcmTookQuestReq=알크퀘스트요청수락
JohnnyAnotherPlayerClearFlag=조니다른플레이어클리어플래그
NnpcFinishHintTalk=NNPC힌트대화완료
HgsCloseness=HGS친밀도
HgsTalkTodayFlag=HGS오늘대화플래그
NnpcApproachNoEmoticonCount=NNPC접근이모티콘없음횟수
HgsAllowAddFriendship=HGS우정추가허용
MainmenuCall=메인메뉴통화
EmergencyEscapeExplain=긴급탈출설명
HHAGradeMailFlag=HHA등급메일플래그
EnableSmatDeviceNortification=스마트기기알림활성화
CatchFishFes_Bonus=낚시축제_보너스
CatchFishFes_CooperativeBonus=낚시축제_협력보너스
CatchInsectFes_Bonus=곤충축제_보너스
CatchInsectFes_CooperativeBonus=곤충축제_협력보너스
LookNpcHouseVisitNpc=NPC집방문NPC보기
MainmenuFriendList=메인메뉴친구목록
FriendListMainSwitch=친구목록메인스위치
SnowmanGotDay1Flag=눈사람1일획득플래그
SnowmanGotDay2Flag=눈사람2일획득플래그
SnowmanGotDay3Flag=눈사람3일획득플래그
SnowmanGotDay4Flag=눈사람4일획득플래그
MainmenuOnlineShopping=메인메뉴온라인쇼핑
MainmenuRndDailyQuest=메인메뉴랜덤일일퀘스트
MainmenuAchievement=메인메뉴업적
SnowmanBuildFlag=눈사람건설플래그
SnowmanFirstBuildTodayFlag=눈사람오늘첫건설플래그
ObjRcoMachineCheck1st=오브젝트알코기계첫체크
ReservedNpcGroupActivityMorning=예약NPC그룹활동아침
ReservedNpcGroupActivityNoon=예약NPC그룹활동점심
ReservedNpcGroupActivityEvening=예약NPC그룹활동저녁
ReservedNpcGroupActivityNignt=예약NPC그룹활동밤
RcoMoveHouseReserved=알코집이동예약
RcoChangeHouseDesignReserved=알코집디자인변경예약
RcoMoveNpcHouseFacilityReserved=알코NPC집시설이동예약
PlayerSonkatsuQuestEnable=플레이어손카츠퀘스트활성화
RcoMoveShopReserved=알코상점이동예약
RcoMoveMuseumReserved=알코박물관이동예약
RcoMoveTailorReserved=알코재단사이동예약
ChyDaily_TalkFirst=챠일일_첫대화
BeyDaily_TalkFirst=베이일일_첫대화
BeyDaily_QuestClear=베이일일_퀘스트클리어
AccessLostPropertyBox1st=분실물함첫접근
Mobile1stBoot_Camera=모바일첫부팅_카메라
Mobile1stBoot_MilageProgram=모바일첫부팅_마일리지프로그램
Mobile1stBoot_MilagePlus=모바일첫부팅_마일리지플러스
Mobile1stBoot_Encyclopedia=모바일첫부팅_도감
Mobile1stBoot_DIYrecipe=모바일첫부팅_DIY레시피
Mobile1stBoot_OnlineShopping=모바일첫부팅_온라인쇼핑
Mobile1stBoot_Mydesign=모바일첫부팅_내디자인
Mobile1stBoot_SharePlay=모바일첫부팅_공유플레이
Mobile1stBoot_BestFriend=모바일첫부팅_베스트프렌드
Mobile1stBoot_Passport=모바일첫부팅_여권
Mobile1stBoot_Map=모바일첫부팅_지도
Mobile1stBoot_SOS=모바일첫부팅_SOS
RctTalkBeforeFalg=알크트이전대화플래그
AmountHeardPublicAnnouncement=공지사항들음횟수
SzaTalkAboutOfficeService=사자오피스서비스대화
SzaFlowerQuestClear=사자꽃퀘스트클리어
RcoTalkAboutBuildBridge=알코다리건설대화
RcoTalkAboutBuildSlope=알코경사로건설대화
RcoTalkAboutDeleteBridgeSlope=알코다리경사로삭제대화
RcoBuildBridgeReserved=알코다리건설예약
RcoBuildSlopeReserved=알코경사로건설예약
RcoDeleteBridgeSlopeReserved=알코다리경사로삭제예약
RcoDeleteSlopeReserved=알코경사로삭제예약
OwlShowFossilMyself=부엉이직접화석보여줌
RcmShowHardWood=알크단단한나무보여줌
RcoTalkAfterMuseumTent=알코박물관텐트후대화
PlayerGotHardWood=플레이어단단한나무획득
RcmSellCampingStuffReaction=알크캠핑용품판매반응
OBJRcoMachineChkPlusEnable=오브젝트알코기계체크플러스활성화
SysCountOpenedToolManual=시스템도구매뉴얼열기횟수
RcoHeardThanksForBuiltOwlTent=알코부엉이텐트건설감사들음
AnnouncementOwlMovedIn=부엉이입주공지
RcmTalkAboutCupboard=알크수납장대화
RcoDonateStatus=알코기부상태
RcoGotLoginBonusToday=알코오늘로그인보너스획득
RcoMachineDailyLoginDays=알코기계일일로그인일수
RcoMachineDailyLoginCheck=알코기계일일로그인체크
RcoMachineEnableExchange=알코기계교환활성화
JohnnyPartsCount=조니부품횟수
BeyDaily_QuestCount=베이일일_퀘스트횟수
TalkRumorPActionTodayAnyone=오늘누구든P액션소문대화
TalkRumorPFavoriteTodayAnyone=오늘누구든P좋아요소문대화
IsToolShortcutManualOpen=도구단축키매뉴얼열림여부
RcoMachineExplainAboutPlaneTicket=알코기계비행기표설명
DodExplainAboutMysteryTour=도드미스터리투어설명
IsGetMessageBottle=메시지병획득여부
DodFirstTalkAfterPlusEnable=도드플러스활성화후첫대화
ImmQHousingKitGetFirst=이민Q주택키트첫획득
ImmQFirstExplain=이민Q첫설명
ImmQRunningForPlayer=이민Q플레이어를위해실행중
DodUseFirstFreeTour=도드첫무료투어사용
AppUrgentEscapeUseToday=앱긴급탈출오늘사용
AppUrgentEscapeNoPayment=앱긴급탈출결제없음
ImmQSetHousingAbyMySelf=이민Q주택A직접설정
ImmQSetHousingBbyMySelf=이민Q주택B직접설정
ImmQSetHousingCbyMySelf=이민Q주택C직접설정
ImmQSetOutdoorAbyMySelf=이민Q야외A직접설정
ImmQSetOutdoorBbyMySelf=이민Q야외B직접설정
ImmQSetOutdoorCbyMySelf=이민Q야외C직접설정
RcoHeardNoticeOfficeBuild=알코오피스건설공지들음
RcoTalkBeforeCountdown=알코카운트다운전대화
RcoTalkAfterCountdown=알코카운트다운후대화
ChyDaily_TalkFirstDay=챠일일_첫대화일
ChyDaily_SellCount=챠일일_판매횟수
ChyDaily_SellFirst=챠일일_첫판매
NetIsRegistHomeLand=넷홈랜드등록여부
FriendListNotifyUpdate=친구목록알림업데이트
FriendListNotifyLook=친구목록알림보기
CatchFishContinueCount=연속물고기잡기횟수
FriendMailSendEnable=친구메일전송활성화
BeyDaily_TalkFirstDay=베이일일_첫대화일
PrayStarToday=오늘별빌기
StarPieceGrowCount=별조각성장횟수
BeyDaily_QuestStart=베이일일_퀘스트시작
KinuyoChkMydesginFlag=키누요내디자인체크플래그
HgsGotCloth=HGS옷획득
RcmDeliver_00=알크배달_00
HasTalkedAllVillagerToday=오늘모든주민과대화했음
AmiiboPhoneTalkFirst=아미보폰첫대화
PrintServiceExplain=인쇄서비스설명
SendPuromaidoCount=푸로마이도전송횟수
KinuyoTalkInTailorFlag=키누요재단사에서대화플래그
KinuyoForcesTalkTodayFlag=키누요강제대화오늘플래그
KinuyoForcedTalk2TodayFlag=키누요강제대화2오늘플래그
ChyEvent_TotalPoint=챠이벤트_총포인트
BeyEvent_TotalPoint=베이이벤트_총포인트
ChyEvent_GetTrophyGold=챠이벤트_금트로피획득
ChyEvent_GetTrophySilver=챠이벤트_은트로피획득
ChyEvent_GetTrophyCopper=챠이벤트_동트로피획득
BeyEvent_GetTrophyGold=베이이벤트_금트로피획득
BeyEvent_GetTrophySilver=베이이벤트_은트로피획득
BeyEvent_GetTrophyCopper=베이이벤트_동트로피획득
PurchaseBoxUseOnceFlag=구매상자한번사용플래그
BeyDaily_ReqObj=베이일일_요청오브젝트
ChyDaily_ReqObj=챠일일_요청오브젝트
BeyDaily_ExplainReqObj_First=베이일일_요청오브젝트설명첫번째
ChyDaily_ExplainReqObj_First=챠일일_요청오브젝트설명첫번째
KinuyoTailorBuildFlag=키누요재단사건설플래그
BirthdayPToldlPartySharePlay=생일P파티공유플레이말함
TalkSnpcTodayAnyone=오늘누구든SNPC대화
RcmForcedTalkTodayFlag=알크강제대화오늘플래그
RcmForcedTalk2TodayFlag=알크강제대화2오늘플래그
KinuyoMetShopFlag=키누요상점만남플래그
ImmQGetHousingFullItem=이민Q주택가득한아이템획득
TownNewsReserve=마을소식예약
BeyDaily_ExolainQ_First=베이일일_퀘스트설명첫번째
ImmQHeardClearInfoA=이민QA클리어정보들음
ImmQHeardClearInfoB=이민QB클리어정보들음
ImmQHeardClearInfoC=이민QC클리어정보들음
ImmQHeardNoticeRemoveFtr=이민Q가구제거공지들음
RcoImmQClear1QuestToday=알코이민Q오늘1퀘스트클리어
ImmQTalkRcoHaveBridgeKit=이민Q알코다리키트보유대화
ImmQTalkRcoBridgeKitSet=이민Q알코다리키트설정대화
ImmQSetBridgeKitMySelf=이민Q직접다리키트설정
ImmQTalkRcoBridgeComplete=이민Q알코다리완성대화
ImmQTalkAboutPrize=이민Q상품대화
ImmQGetQuestPrize=이민Q퀘스트상품획득
ChyDaily_AnnounceEvent=챠일일_이벤트공지
BeyDaily_AnnounceEvent=베이일일_이벤트공지
CampInvite=캠프초대
CampFirstTalk=캠프첫대화
CampQuestAccept=캠프퀘스트수락
CampQuestRecipiFailed=캠프퀘스트레시피실패
CampQuestRejected=캠프퀘스트거절
CampGameGetRare=캠프게임레어획득
Camp_InduceFailFlag=캠프_유도실패플래그
Camp_InduceFailSameNpcLiving=캠프_같은NPC거주유도실패
Camp_InduceFailSameNpcMoveIn=캠프_같은NPC입주유도실패
Camp_InduceFailVillagerMax=캠프_주민최대유도실패
Camp_InduceFailSellPlaceNothing=캠프_판매장소없음유도실패
CalendarEventAchievementFinish=캘린더이벤트업적완료
RollanGotWallpaperFlag=롤란벽지획득플래그
RollanGotCarpetFlag=롤란카펫획득플래그
ImmQTakeFruit=이민Q과일가져가기
ImmQTakeRemakeKit=이민Q리메이크키트가져가기
ImmQBridgeMadeinRcoTent=이민Q알코텐트에서만든다리
IslandDevQuestShowCampKit=섬개발퀘스트캠프키트보여주기
IslandDevQuestCampMadeRcotent=섬개발퀘스트캠프알코텐트에서만듦
IslandDevQuestTalkAfterCampSet=섬개발퀘스트캠프설정후대화
IslandDevQuestCampSetMySelf=섬개발퀘스트직접캠프설정
IslandDevQuestGetRecipeCampKit=섬개발퀘스트캠프키트레시피획득
IslandDevQuestOrderFirstCamperMyself=섬개발퀘스트첫캠퍼직접주문
MainmenuConstructLicense=메인메뉴건설라이센스
FirstPlayAfterOfficeBuiltFlag=오피스건설후첫플레이플래그
FirstPlayAfterShopBuiltFlag=상점건설후첫플레이플래그
FirstPlayAfterShopBuilt2Flag=상점2건설후첫플레이플래그
FirstPlayAfterMuseumTentFlag=박물관텐트후첫플레이플래그
FirstPlayAfterMuseumBuiltFlag=박물관건설후첫플레이플래그
FirstPlayAfterTailorBuiltFlag=재단사건설후첫플레이플래그
SzaHeardTodayIslandEvaluation=사자오늘섬평가들음
IslandEvaluationUnlockMyself=섬평가직접언락
SzaHeardAboutIslandEvaluation=사자섬평가들음
ConstructionWorkToday=오늘공사작업
PlayToday=오늘플레이
TalkFreeIPresentTodayAnyone=오늘누구든무료I선물대화
IslandDevQuestTalkAfterBuildCamp=섬개발퀘스트캠프건설후대화
IslandDevQuestTalkAboutFirstCamper=섬개발퀘스트첫캠퍼대화
GetHousingKitForFirstCamper=첫캠퍼용주택키트획득
ItemFullHousingKitForFirstCamper=첫캠퍼용주택키트아이템가득
SetHousingKitForFirstCamper=첫캠퍼용주택키트설정
ChyDaily_InsectSellNum=챠일일_곤충판매수
SharePlayGuideDone=공유플레이가이드완료
CommuneIslandAvailable=공동체섬이용가능
VisitedCommune=공동체방문
ChyEvent_TalkTrophyGold=챠이벤트_금트로피대화
ChyEvent_TalkTrophySilver=챠이벤트_은트로피대화
ChyEvent_TalkTrophyCopper=챠이벤트_동트로피대화
BeyEvent_TalkTrophyGold=베이이벤트_금트로피대화
BeyEvent_TalkTrophySilver=베이이벤트_은트로피대화
BeyEvent_TalkTrophyCopper=베이이벤트_동트로피대화
SpnFirstTalkedAtCommuneIsland=스폰공동체섬에서첫대화
AppUrgentEscapeCallToday=앱긴급탈출오늘통화
KotonoGotSampleFlag=코토노샘플획득플래그
KotonoGotTicketFlag=코토노티켓획득플래그
OwsFirstTalk=오우스첫대화
OwsTalkedToday=오우스오늘대화
OwsPresentFirstRecipe=오우스첫레시피선물
SpnPhotoStudioGuideDone=스폰포토스튜디오가이드완료
GetBirthdayCake=생일케이크획득
GetBirthdayFloorParty=생일바닥파티획득
GetBirthdayWallParty=생일벽파티획득
AddHairStyle1=헤어스타일1추가
AddHairStyle2=헤어스타일2추가
AddHairStyle3=헤어스타일3추가
TanuportAmiiboBromideUnlock=타누포트아미보브로마이드언락
AddHairColor=헤어컬러추가
EnableDiyRemake=DIY리메이크활성화
GetLicenseGrdStone=라이센스돌바닥획득
GetLicenseGrdBrick=라이센스벽돌바닥획득
GetLicenseGrdDarkSoil=라이센스어두운흙바닥획득
GetLicenseGrdStonePattern=라이센스돌무늬바닥획득
GetLicenseGrdSand=라이센스모래바닥획득
GetLicenseGrdTile=라이센스타일바닥획득
GetLicenseGrdWood=라이센스나무바닥획득
GetLicenseRiver=라이센스강획득
GetLicenseCliff=라이센스절벽획득
EquipLicenseHelmet=라이센스헬멧장착
OwsPresentTodayRecipe=오우스오늘레시피선물
OwsPresentThisZodiacRecipe=오우스이번황도대레시피선물
OwsThisZodiac=오우스이번황도대
NewYearPlayReportSend=새해플레이리포트전송
RctOutsideHintToday=알크트외부힌트오늘
DecideShopArea=상점구역결정
HeardEatingHintAtShop=상점에서식사힌트들음
KinuyoExplainFittingRoomFlag=키누요피팅룸설명플래그
HasLookMyHouseExplain=내집보기설명했음
TownNewsHeardRemakeTrialFlag=마을소식리메이크시연들음플래그
RcoEnableRemakeTrial=알코리메이크시연활성화
RcoRemakeTrialOngoing=알코리메이크시연진행중
RcoRemakeTrialGetFurniture=알코리메이크시연가구획득
RcoTalkAboutRemakeTrial=알코리메이크시연대화
RcoStayMyHouseImmQClear=알코내집에머물이민Q클리어
1stPresentHatType=첫번째선물모자타입
DodHeardAboutMileTravelTicket=도드마일여행티켓들음
DocMysterytourExplain1st=도크미스터리투어첫설명
CampGameClear=캠프게임클리어
RctTnx4CollectingMaterials=알크트재료수집감사
RctTnx4CollectingMaterials2=알크트재료수집감사2
RctTnx4ConfirmingStorePlace=알크트상점위치확인감사
RcoFinishAdvice=알코조언완료
RumorPFavoriteProgressDays=P좋아요소문진행일수
PAnnounceExplainCeremony=P공지의식설명
PAnnounceTailorBuilt=P공지재단사건설
RctHintCongratsMyhome=알크트내집축하힌트
PAnnounceCampsite=P공지캠프사이트
PAnnounceHeardOfficeRenual=P공지오피스리뉴얼들음
RcoFirstTalkNewOffice=알코새오피스첫대화
ItemRingEnable=아이템링활성화
RcoTalkAboutOfficeWork=알코오피스작업대화
TwinTurnipExplanation=쌍둥이무설명
HeldCeremonyMarket1=시장1의식개최
HeldCeremonyMarket2=시장2의식개최
HerdCeremonyOffice=오피스의식개최
HeldCeremonyMuseum=박물관의식개최
HeldCeremonyTailor=재단사의식개최
HeldCeremonyCampSite=캠프사이트의식개최
HeldCeremonyBridge=다리의식개최
HeldCeremonySlope=경사로의식개최
HghPeddlerPurchaceToday=HGH행상오늘구매
RollanBuyWallpaperCount=롤란벽지구매횟수
RollanBuyCarpetCount=롤란카펫구매횟수
RcoTalkAboutMoveBuilding=알코건물이동대화
UseMigrantHousingKit1st=이주민주택키트첫사용
RcoHeardLadderExplain=알코사다리설명들음
RcoReciveMigrantEvPhone1st=알코이주민이벤트폰첫수신
SzaTalkAboutIncresePopulation=사자인구증가대화
RcoMoveCampSiteReserved=알코캠프사이트이동예약
SkkPurchaseToday=스크크오늘구매
SkkTalkTodayFlag=스크크오늘대화플래그
TkkFirstLiveJoined=토타케케첫라이브참가
FirstPlayAfterPlayerMake=플레이어생성후첫플레이
RcoMigrantProgressTalk1st=알코이주민진행첫대화
DodTodayFlightMileGet=도드오늘비행마일획득
PAnnouceHeardRemakeWsNewsToday=P공지리메이크WS뉴스오늘들음
HghGetTailorHousingKit=HGH재단사주택키트획득
SzaTalkAboutIncreseHousingKit=사자주택키트증가대화
HghHeardRequestHousingKit=HGH주택키트요청들음
HghEndRequestHousingKit=HGH주택키트요청종료
OfficeSzaIntroduction=오피스사자소개
PAnnouceHeardKkProject=P공지KK프로젝트들음
RcoHeardAboutKkProject1st=알코KK프로젝트첫번째들음
GetLicenseGrdMydesign=라이센스내디자인바닥획득
RcoHeardAbout1stCamperToday=알코오늘첫캠퍼들음
RcoHeardAboutEvaluationStart=알코평가시작들음
RcoHeardAboutEvalutationDetail=알코평가상세들음
RcoAwaitingExplanation=알코설명대기중
SzaHeardAboutEvaluationDetail=사자평가상세들음
PopDiyGoldFromStoneToday=오늘돌에서DIY금나옴
BeyEvent_TalkFirst=베이이벤트_첫대화
AppUrgentEscapeMobCounter=앱긴급탈출모바일카운터
AppUrgentEscapeTodayShiftMob=앱긴급탈출오늘시프트모바일
GotMedicineRecipe=약레시피획득
MessageCardPayment=메시지카드결제
PlayerHalfAsleepDemoFlag=플레이어반쯤잠든데모플래그
ChyEvent_TalkFirst=챠이벤트_첫대화
RcoWallFtrRemoveHouseRemodel=알코벽가구제거집리모델
LegacyMyDesignDLEnable=레거시내디자인다운로드활성화
Got2ndLoach=2번째미꾸라지획득
PlayReportDaily=일일플레이리포트
RemakeWs_TalkWhenItemFull=리메이크WS_아이템가득할때대화
ImmQCompleteDemo=이민Q완료데모
DodSelectCommune1st=도드공동체첫선택
SpnTalkAtHomelandToday=스폰오늘고향에서대화
SpnTalkAtCommuneToday=스폰오늘공동체에서대화
UpgradePocket30=주머니30업그레이드
UpgradePocket40=주머니40업그레이드
IllegalReportCount=불법신고횟수
SellPocket40=주머니40판매
BeyDaily_GetDemo_Clear=베이일일_데모획득_클리어
OpenDIYRecipeEtcCategory=DIY레시피기타카테고리열기
RcoBuildBridgeSlopeMyself=알코직접다리경사로건설
RcoRemoveBridgeSlopeMyself=알코직접다리경사로제거
RcoTalkAboutBuildBridgeSlope=알코다리경사로건설대화
RcoTalkAboutHaniwa=알코하니와대화
PAnnounceHintRnd=P공지힌트랜덤
PickUpFirst=첫번째줍기
StandByGameStartPhoneCall=게임시작전화대기
StandByPhoneCallPrintService=인쇄서비스전화대기
StandByPhoneCallSharePlay=공유플레이전화대기
StandByPhoneCallPurchaseBox=구매상자전화대기
HeardAboutFreeDKeywordA=무료D키워드A들음
HeardAboutFreeDKeywordB=무료D키워드B들음
HeardAboutFreeDKeywordC=무료D키워드C들음
RcoMoveSomeBuiding=알코일부건물이동
BuiltMyHome=내집건설
RcoMoveHousingSetSomeBuild=알코주택설정일부건물이동
SzaIslandEvaluation5star1st=사자섬평가5성첫번째
JohnnySitUpBeforeFlag=조니앉기전플래그
CampFirstTalk_FirstVisitor=캠프첫대화_첫방문자
BocAllowAddBuyCount=보크구매횟수추가허용
BocBuyCount=보크구매횟수
BocBuyNumCount=보크구매수량횟수
EmoticonLastLearnVillagerIndex=이모티콘마지막학습주민인덱스
MainmenuUnlockMydesingPro=메인메뉴내디자인프로언락
HeardCurrentPlayerActivityInfo=현재플레이어활동정보들음
HeardPreviousPlayerActivityInfo=이전플레이어활동정보들음
DodPresentCounter=도드선물카운터
DodPresentCounterToday=도드오늘선물카운터
DodSingleFlightToday=도드오늘단독비행
DodPresentSendCounter=도드선물전송카운터
BDayMsgSenderSNpcUniqueID0=생일메시지발신자SNPC고유ID0
BDayMsgSenderSNpcUniqueID1=생일메시지발신자SNPC고유ID1
BDayMsgSenderNNpcUniqueID0=생일메시지발신자NNPC고유ID0
BDayMsgSenderNNpcUniqueID1=생일메시지발신자NNPC고유ID1
BDayMsgRandomSead=생일메시지랜덤시드
UnlockMyDesignProCategory=내디자인프로카테고리언락
BalloonShootCountToday=오늘풍선쏘기횟수
ContributedBuildBridgeorSlope=다리또는경사로건설기여
ContributedTodaysCeremonyBridgeorSlope=오늘의식다리또는경사로기여
Mobile1stBootAfterUnlockPro_Mydesign=프로내디자인언락후모바일첫부팅
TkkBirthdayMessageFlag=토타케케생일메시지플래그
TalkFirstCamperAfterSetHousing=주택설정후첫캠퍼대화
TalkFirstCamperAfterRequestSetHousing=주택설정요청후첫캠퍼대화
NnpcAppE_Rep_OccuredToday=NNPC앱E_리포트오늘발생
SzaPAAccidentCounter=사자PA사고카운터
SzaIslandEvaluationTalkAbout1Star=사자섬평가1성대화
SzaIslandEvaluationHeardToday=사자섬평가오늘들음
DailyQuestFivePointDay=일일퀘스트5포인트일
DailyQuestFirstFivePoint=일일퀘스트첫5포인트
DailyQuestFivePointMiss=일일퀘스트5포인트실패
DailyQuestFivePointQuest=일일퀘스트5포인트퀘스트
DailyQuestFirstFivePointToday=일일퀘스트오늘첫5포인트
DailyQuestFivePointSelect=일일퀘스트5포인트선택
AppE_WelcomoMigrants_Occured=앱E_이주민환영발생
BeyEvent_ResultGetFish=베이이벤트_결과물고기획득
ChyEvent_ResultGetInsect=챠이벤트_결과곤충획득
KotonoKateTalkFlag=코토노케이트대화플래그
BeyEvent_ResultGetPoint=베이이벤트_결과포인트획득
ChyEvent_ResultGetPoint=챠이벤트_결과포인트획득
PhoneCallByRcm=알크에의한전화
PhoneCallByRct=알크트에의한전화
ThisPCcreatedbeforeOfficeUpgrading=이PC는오피스업그레이드전에생성됨
RcoMachineAmiiboCamperUnlock=알코기계아미보캠퍼언락
ObjRcoMachineHeardExplanation=오브젝트알코기계설명들음
OwlHeardInsectExplanation=부엉이곤충설명들음
OwlEverDonatedInsect=부엉이곤충기부한적있음
2P_CreatedAfterOwlMoving=2P는부엉이이동후생성됨
OwlGotDiyRecipe=부엉이DIY레시피획득
RcoTalkAboutMoveMyHome=알코내집이동대화
RcoPAnnounceMuseumSP=알코P공지박물관SP
PAnnounceHeardMarketUpgradeInfo=P공지시장업그레이드정보들음
PAnnounceHeardMarketUpgradeInfoSza=P공지사자시장업그레이드정보들음
NoticeAboutLicenseRiver=라이센스강공지
NoticeAboutLicenseCliff=라이센스절벽공지
OdekakeFirstInternet=외출첫인터넷
UploadProfileGrowupDaily=프로필성장일일업로드
GoldenBalloonCount=골든풍선횟수
GoldenAxeLearningCount=골든도끼학습횟수
LastUseLicense=마지막라이센스사용
GoldenRodRecipeSent=골든낚시대레시피전송
GoldenNetRecipeSent=골든그물레시피전송
CompleteFish=물고기완성
CompleteInsects=곤충완성
Experienced3starEvaluation=3성평가경험
CountGotTrash=쓰레기획득횟수
CountGotTrash_Can=쓰레기캔획득횟수
CountGotTrash_Tire=쓰레기타이어획득횟수
JohnnyHelpCount=조니도움횟수
CatchtFesBox_Valid=잡기축제상자_유효
TreasurePlayerWin=보물플레이어승리
PAnnounce_SummerShell=P공지_여름조개
PAnnounce_AutumnNuts=P공지_가을견과류
UploadPlayerProfileIllegal=플레이어프로필불법업로드
PAnnounce_AutumnMushroom=P공지_가을버섯
PAnnounce_WinterSnowFlake=P공지_겨울눈송이
PAnnounce_WinterSnowball=P공지_겨울눈덩이
PAnnounce_WinterOrnament=P공지_겨울장식
NotStartImmQByDIYDisable=DIY비활성화로이민Q시작안함
PAnnounce_AutumnRedLeaf=P공지_가을빨간잎
PAnnounce_SpringSakura=P공지_봄벚꽃
PAnnounce_SpringBamboo=P공지_봄대나무
RcoHeardInviteRemakeWS=알코리메이크WS초대들음
KinuyoPROdesginFlag=키누요PRO디자인플래그
NoticeAboutMydesingOnWorkBench=작업대에서내디자인공지
LatestMysteryTourUniqueID=최신미스터리투어고유ID
OwlMultiDonateExplain=부엉이다중기부설명
StandByPhoneCallIslandCreater=섬크리에이터전화대기
PastDaysFromLastPlay=마지막플레이후경과일수
UncollectedTreasure=미수집보물
VisitMysteryTourID11=미스터리투어ID11방문
VisitMysteryTourID12=미스터리투어ID12방문
VisitMysteryTourID13=미스터리투어ID13방문
VisitMysteryTourID14=미스터리투어ID14방문
VisitMysteryTourID16=미스터리투어ID16방문
VisitMysteryTourID17=미스터리투어ID17방문
VisitMysteryTourID19=미스터리투어ID19방문
VisitMysteryTourID21=미스터리투어ID21방문
VisitMysteryTourID24=미스터리투어ID24방문
FriendMailGuideRetentionPeriod=친구메일가이드보관기간
StandByRcoVisitMyHomeAfterTkkFirstLive=토타케케첫라이브후알코내집방문대기
SpnTalkBeforeGotHouseToday=스폰오늘집얻기전대화
TodayGrowUp=오늘성장
KotonoQuestClearCount=코토노퀘스트클리어횟수
PhotoStudioUseCantCallAmiibo=포토스튜디오사용아미보호출불가
ChyDaily_ObjEntry1=챠일일_오브젝트입력1
ChyDaily_ObjEntry2=챠일일_오브젝트입력2
ChyDaily_ObjEntry3=챠일일_오브젝트입력3
BeyDaily_ObjEntry1=베이일일_오브젝트입력1
BeyDaily_ObjEntry2=베이일일_오브젝트입력2
BeyDaily_ObjEntry3=베이일일_오브젝트입력3
BeyDaily_TalkAlways1=베이일일_항상대화1
BeyDaily_TalkAlways2=베이일일_항상대화2
BeyDaily_TalkAlways3=베이일일_항상대화3
CampQuestRecipeGet=캠프퀘스트레시피획득
Mobile1stBoot_IslandCreater=모바일첫부팅_섬크리에이터
Closet_Explain_ChangeStick=옷장_변경스틱설명
TkkFirstLiveToday=토타케케오늘첫라이브
1stBootIslandCreaterCleanService=첫부팅섬크리에이터클린서비스
MarketBuiltMyVillage=내마을시장건설
Mobile1stBootUnlockCantEditMydesign=모바일첫부팅내디자인편집불가언락
DodHeardAboutIslandCreator=도드섬크리에이터들음
SzaBeforeIslandEvaluation=섬평가전사자
PAnnouceProcessDoneToday=P공지오늘프로세스완료
ImprovePlayerProfile=플레이어프로필개선
EnableInviteMoveoutNPC=이사NPC초대활성화
TodayMainGrowUp=오늘메인성장
SzaTalkAtOfficeToday=사자오늘오피스에서대화
MainmenuChatLog=메인메뉴채팅로그
Mobile1stBoot_ChatLog=모바일첫부팅_채팅로그
Activate_WebService=웹서비스활성화
MyDesignExchangeFirstAccess=내디자인교환첫접근
MyDesignExchangeUploadOnce=내디자인교환한번업로드
OhirakiRollbackTutorial=오히라키롤백튜토리얼
SzaTalkFirstNotOffice=사자첫대화오피스아님
Talk1stCamperMultiplay=첫캠퍼멀티플레이대화
EasterTodayRecipeRandomGenerateNum=이스터오늘레시피랜덤생성수
ObjRcoMachineHeardFenceRecipe=오브젝트알코기계울타리레시피들음
WinningProbabilityOfEasterEggGroundRecipe=이스터달걀땅레시피당첨확률
WinningProbabilityOfEasterEggRockRecipe=이스터달걀바위레시피당첨확률
WinningProbabilityOfEasterEggLeafRecipe=이스터달걀잎레시피당첨확률
WinningProbabilityOfEasterEggForestRecipe=이스터달걀숲레시피당첨확률
WinningProbabilityOfEasterEggSkyRecipe=이스터달걀하늘레시피당첨확률
WinningProbabilityOfEasterEggFishRecipe=이스터달걀물고기레시피당첨확률
ShootDownEasterRecipeBalloon=이스터레시피풍선쏘기
EasterRecipeAddLotNum=이스터레시피추가로트수
PynTalkBeforeFlag=파인이전대화플래그
PynTalkBackTodayFlag=파인오늘돌아오기대화플래그
PynTalkPreVisitDayFlag=파인방문전날대화플래그
PynTalkEasterDayFlag=파인이스터데이대화플래그
PynCannotGetItemFlag=파인아이템획득불가플래그
PynExplainExchangeEggsFlag=파인달걀교환설명플래그
PynExplainInventRecipeFlag=파인발명레시피설명플래그
PynExplainNnpcRecipeFlag=파인NNPC레시피설명플래그
PynGetFirstRecipeEasterDayFlag=파인이스터데이첫레시피획득플래그
PynGetFinalMissionRecipeFlag=파인최종미션레시피획득플래그
PynCompleteDiyMissionFlag=파인DIY미션완료플래그
PynGetEggBasketFlag=파인달걀바구니획득플래그
PynExplainEasterDateFlag=파인이스터날짜설명플래그
SetMessageBottleEgg=메시지병달걀설정
SetTreeEggLeaf=나무달걀잎설정
BuryEggGround=땅에달걀묻기
IsGetMessageBottleEgg=메시지병달걀획득여부
HitMessageBottleEgg=메시지병달걀맞춤
MissMessageBottleEgg=메시지병달걀빗나감
EasterNnpcRecipeCount=이스터NNPC레시피횟수
LastEasterApproachVillagerIndex=마지막이스터접근주민인덱스
OpenDIYRecipeSeasonCategory=DIY레시피계절카테고리열기
LastPlayEasterYear=마지막이스터플레이년도
PynEvent_SendRecipeMail=파인이벤트_레시피메일전송
PynGetPreVisitRecipeFlag=파인방문전레시피획득플래그
PynInventRecipeFlag=파인발명레시피플래그
SnowmanDIYMailFlag=눈사람DIY메일플래그
AlwJuneBrideDayCount=알우6월신부일카운트
EasterCannotGetNnpcRecipeFlag=이스터NNPC레시피획득불가플래그
AlwJuneBrideQuestStartFlag=알우6월신부퀘스트시작플래그
AlwJuneBrideQuestClearFlag=알우6월신부퀘스트클리어플래그
StampRallyRunningForPlayer=플레이어를위한스탬프랠리진행중
OwlInsectStampRally1=부엉이곤충스탬프랠리1
OwlInsectStampRally2=부엉이곤충스탬프랠리2
OwlInsectStampRally3=부엉이곤충스탬프랠리3
OwlFishStampRally1=부엉이물고기스탬프랠리1
OwlFishStampRally2=부엉이물고기스탬프랠리2
OwlFishStampRally3=부엉이물고기스탬프랠리3
OwlFossilStampRally1=부엉이화석스탬프랠리1
OwlFossilStampRally2=부엉이화석스탬프랠리2
OwlFossilStampRally3=부엉이화석스탬프랠리3
AlpJuneBrideExchangeFlag=알프6월신부교환플래그
AlwJuneBrideRemakeOpenFlag=알우6월신부리메이크오픈플래그
MailSendFlag_VersionUp=메일전송플래그_버전업
MailSendFlag_BundledEdition=메일전송플래그_번들에디션
GetMayDayTicket=메이데이티켓획득
PAnnouncePreEaster=P공지이스터전
ShootDownEasterOverCountRecipeBalloon=이스터초과카운트레시피풍선쏘기
RcoEarthDayAnnouncement=알코지구의날공지
RcoEarthDayGetHedge=알코지구의날헤지획득
SloTalkAboutHedge=슬로헤지대화
SloBuyCount=슬로구매횟수
TalkRumorOVlgFavoriteToday=오늘OVlg좋아요소문대화
EasterCompleteFlag=이스터완료플래그
PhoneCallPrintServiceDelayFlag=전화인쇄서비스지연플래그
EarthdayDailyAllClear=지구의날일일올클리어
GetCountEasterEggGround=이스터달걀땅획득횟수
GetCountEasterEggRock=이스터달걀바위획득횟수
GetCountEasterEggLeaf=이스터달걀잎획득횟수
GetCountEasterEggForest=이스터달걀숲획득횟수
GetCountEasterEggSky=이스터달걀하늘획득횟수
GetCountEasterEggFish=이스터달걀물고기획득횟수
DodHeardAboutMayDayTravelTicket=도드메이데이여행티켓들음
UseMayDayTicket=메이데이티켓사용
OwlShowPaintingMyself=부엉이직접그림보여줌
Owl1stTalkMuseum2=부엉이박물관2첫대화
OwlPaintingQuestExplain=부엉이그림퀘스트설명
FutaReadyForMuseum2=후타박물관2준비
HeldCeremonyMuseum2=박물관2의식개최
EarthdayDailyClearNum=지구의날일일클리어수
OwlShowPaintingBeforeQuest=부엉이퀘스트전그림보여줌
OwlPaintingQuestDeclined=부엉이그림퀘스트거절
LastIslandRepApproachVillagerIndex=마지막섬대표접근주민인덱스
ChangedPermanentNum=영구변경수
ClearMayDayTour=메이데이투어클리어
NnpcApproachNoIslandRepCount=NNPC섬대표없음접근횟수
JuneBridePlacementDataClearFlag=6월신부배치데이터클리어플래그
SloGetHedge=슬로헤지획득
XctGerReward=엑스크트독일보상
SpnJuneBrideClearTalkFrag=스폰6월신부클리어대화플래그
AlwJuneBrideTalkBeforeFlag=알우6월신부이전대화플래그
AlpJuneBrideTalkBeforeFlag=알프6월신부이전대화플래그
SpnJuneBrideTalkEventFrag=스폰6월신부이벤트대화플래그
PynVisitYear=파인방문년도
PynVisitToday=파인오늘방문
OwlStampPlayed=부엉이스탬프플레이
OwlStampPocketWasFull=부엉이스탬프주머니가득
OwlStampGotInsectReward=부엉이스탬프곤충보상획득
OwlStampGotFishReward=부엉이스탬프물고기보상획득
OwlStampGotFossilReward=부엉이스탬프화석보상획득
DocDeliveryPurchaseExplain=도크배송구매설명
TalkRumorN2TodayAnyone=오늘누구든N2소문대화
TownNewsHeardMuseum2OpenFlag=마을소식박물관2오픈들음플래그
KinuyoMydesginMachineFlag=키누요내디자인기계플래그
OwlStampGotInsect=부엉이스탬프곤충획득
OwlStampGotFish=부엉이스탬프물고기획득
OwlStampGotFossil=부엉이스탬프화석획득
CompleteEventMayDay=메이데이이벤트완료
AlwJuneBrideDayAlreadyCount=알우6월신부일이미카운트
PAnnounceEarthDay=P공지지구의날
TipsChatFlag=팁채팅플래그
RcoEarthDayAnnouncementPre=알코지구의날공지전
FoxPreVisitBuyArtFlag=여우방문전미술품구매플래그
FoxPreVisitWantSellFlag=여우방문전판매원함플래그
SloTalkedToday=슬로오늘대화
CurrentJuneBrideTheme=현재6월신부테마
PreviousJuneBrideTheme=이전6월신부테마
IsSelectedJuneBrideCuteThisYear=올해6월신부큐트선택됨
IsSelectedJuneBrideChicThisYear=올해6월신부시크선택됨
IsSelectedJuneBrideGardenThisYear=올해6월신부가든선택됨
LastPlayJuneBrideYear=마지막6월신부플레이년도
FoxFirstTalkInShipFlag=여우배에서첫대화플래그
FoxInvitedShipFlag=여우배초대플래그
NoticeAboutSmartPhoneCase=스마트폰케이스공지
AlwJuneBridePleaseShootFlag=알우6월신부촬영부탁플래그
OwlPaintingQuestReminder=부엉이그림퀘스트리마인더
OwlShowDiveFishReport=부엉이다이빙물고기리포트보여줌
DocUsePurchaseServiceFalg=도크구매서비스사용플래그
UsePurchaseBOXFalg=구매상자사용플래그
FoxForcedTalkTodayFlag=여우강제대화오늘플래그
FoxForcedTalk2TodayFlag=여우강제대화2오늘플래그
EDDIYFlowerWreathOrderYear=EDDIY꽃화환주문년도
EDDIYCorollaOrderYear=EDDIY코롤라주문년도
OwlStampGotRewardExplain=부엉이스탬프보상획득설명
UseNavigationMayDayTour=메이데이투어네비게이션사용
FirstPlayAfterMuseumBuilt2Flag=박물관2건설후첫플레이플래그
AlwJuneBrideTotalClearCount=알우6월신부총클리어횟수
SloTalkedWeedFirst=슬로잡초첫대화
SpnJuneBrideGetFenceFrag=스폰6월신부울타리획득플래그
SpnJuneBrideNotGetFenceTodayFrag=스폰6월신부오늘울타리획득안함플래그
JuneBrideBGMHasUnlocked=6월신부BGM언락됨
XctFirstTalk=엑스크트첫대화
PAnnounceJuneBride=P공지6월신부
StandByPhoneCallJuneBrideSpn=6월신부스폰전화대기
AlpJuneBrideGetStickFrag=알프6월신부스틱획득플래그
LastApproachVillagerIndex=마지막접근주민인덱스
StandByPhoneCallJuneBride=6월신부전화대기
OwlExplainDiveFishAfterComp=부엉이완료후다이빙물고기설명
AlwJuneBridePartyTalkFlag=알우6월신부파티대화플래그
AlwJuneBrideLastDayTalkFlag=알우6월신부마지막날대화플래그
VisitFriendMileageGet=친구방문마일리지획득
AlwJuneBrideBalloonFlag=알우6월신부풍선플래그
GstRichItemFlag=거스트부유아이템플래그
MyDesignExchangeDiscloseAuthorID=내디자인교환작자ID공개
TapDiscloseDreamLandID=탭드림랜드ID공개
PlayerPocketUIEnableInCommuneIsland=공동체섬에서플레이어주머니UI활성화
GotoMysteryTour=미스터리투어가기
EnableGotoRareMysteryTour=레어미스터리투어가기활성화
VisitMysteryTourID20=미스터리투어ID20방문
PAnnounceStampRally=P공지스탬프랠리
FoxPreVisitBuyArtMaxFlag=여우방문전미술품최대구매플래그
EDDIYFlowerWreathClearYear=EDDIY꽃화환클리어년도
EDDIYCorollaClearYear=EDDIY코롤라클리어년도
GulBQuestStartFlag=굴B퀘스트시작플래그
GulBQuestFinishFlag=굴B퀘스트완료플래그
GulBTalkBeforeFlag=굴B이전대화플래그
GulBAnotherPlayerClearFlag=굴B다른플레이어클리어플래그
GulBPartsCount=굴B부품횟수
GulBSitUpBeforeFlag=굴B앉기전플래그
InducedNpcNum=유도NPC수
TalkFreeMultiDayEventTodayFlag=오늘무료멀티데이이벤트대화플래그
EarthDayBonus=지구의날보너스
TalkVillagerClearToday=오늘주민클리어대화
EarthDayFirstQuestSystem=지구의날첫퀘스트시스템
EarthDayFirstQuestTalk=지구의날첫퀘스트대화
SeoExchangeItemToday=세오오늘아이템교환
MailSendFlag_EarthDayNotice=지구의날공지메일전송플래그
PAnnounceMayDayTour=P공지메이데이투어
DreamFirstExplain=꿈첫설명
TapDreamFirstTalk=탭꿈첫대화
GulBHelpCount=굴B도움횟수
GulBGetQuestItem=굴B퀘스트아이템획득
HasGottenMarinesuit=해양복획득했음
SeoFirstmeetingFlag=세오첫만남플래그
TalkRumorOActionTodayAnyone=오늘누구든O액션소문대화
SzaFireworksTalkTodayA=사자오늘불꽃놀이대화A
SzaFireworksTalkTodayB=사자오늘불꽃놀이대화B
SzaFireworksRewardToday=사자오늘불꽃놀이보상
FireworksApproachEnd=불꽃놀이접근종료
FireworksApproachNpcIndex=불꽃놀이접근NPC인덱스
FireworksApproachGetFirework=불꽃놀이접근불꽃획득
TapDreamTalkToday=탭꿈오늘대화
TapULFirstExplain=탭UL첫설명
TapDreamUploadToday=탭꿈오늘업로드
TapDreamDeleteToday=탭꿈오늘삭제
PknTalkBeforeFlag=파크닌이전대화플래그
PknTalkTodayFlag=파크닌오늘대화플래그
PknGiveCandyCount=파크닌사탕줌횟수
PknGetCarriageFlag=파크닌마차획득플래그
PknGetBromideFlag=파크닌브로마이드획득플래그
PknGetCarriageRecipeFlag=파크닌마차레시피획득플래그
OwlPaintingDiveFish=부엉이그림다이빙물고기
PAnnounceFireworksSza1=P공지불꽃놀이사자1
RcmBoughtCandyTodayFlag=알크오늘사탕구매플래그
FoxFirstTalkFireworksFlag=여우불꽃놀이첫대화플래그
CharacterCreationFlag=캐릭터생성플래그
PublicAnnouncement_DiveFish=공지사항_다이빙물고기
DiveFish_GetLetter=다이빙물고기_편지획득
DiveFishPublic_1day=다이빙물고기공지_1일
DiveFishPublic_2day=다이빙물고기공지_2일
RcmTalkAboutMarinesuitFlag=알크해양복대화플래그
Encylopedia_DiveFishMes=도감_다이빙물고기메시지
MyDesignExchangeExp_v1_4=내디자인교환경험_v1_4
MyDesignExchangeExp_NormalUsage=내디자인교환경험_일반사용
PlayerHouseBuiltToday=플레이어집오늘건설
ReceiveTapBedLetter=탭침대편지수신
FoxTalkOnlyStandShopFlag=여우오직스탠드상점대화플래그
NpcGetCandyTodayFlag=NPC오늘사탕획득플래그
DiveFish_FirstDonation=다이빙물고기_첫기부
TapSendThankyouLetter=탭감사편지전송
PickUpDIYGoldCount=DIY금줍기횟수
FireworkCannotGetNnpcItemFlag=불꽃놀이NNPC아이템획득불가플래그
SurpriseVisitCount=서프라이즈방문횟수
SurpriseVisitDone=서프라이즈방문완료
GetHalloweenRag=할로윈걸레획득
GetHalloweenWallPaper=할로윈벽지획득
GetHalloweenFloor=할로윈바닥획득
GetHalloweenStickRecipe=할로윈스틱레시피획득
GetHalloweenGarland=할로윈가랜드획득
GetHalloweenTableSetting=할로윈테이블세팅획득
GetHalloweenBag=할로윈가방획득
AddBodyColor=몸색상추가
AddEyeColor=눈색상추가
AddCheekColor=볼색상추가
SaveDataRestoringSettingNotice=세이브데이터복원설정공지
TapTalkAboutMydesignShowcase=탭내디자인쇼케이스대화
NpcHalloweenTrickFlag=NPC할로윈장난플래그
TapFirstDreamIn=탭첫꿈입장
TapFirstCheckMydesingShowcase=탭첫내디자인쇼케이스체크
SpecialMakeChanged=스페셜메이크변경
TalkMakeTodayAnyone=오늘누구든메이크대화
RcmExplainCandyFlag=알크사탕설명플래그
RcmExplainPumpkinFlag=알크호박설명플래그
SzaFireworksSubmitMyDesignToday=사자오늘불꽃놀이내디자인제출
PAnnounceHalloween=P공지할로윈
ExplainPumpkinColorFlag=호박색상설명플래그
SloExplainPumpkinSeedingFlag=슬로호박씨앗설명플래그
CalcPastDays=과거일수계산
PlayerProducedByPlayerMoving=플레이어이동으로생성된플레이어
FireworksLastApproachYear=불꽃놀이마지막접근년도
RcoTalkAboutMovingBelongings=알코이동소지품대화
RcmRctTalkAboutMovingBelongings=알크알크트이동소지품대화
SloExplainAddVegetable=슬로채소추가설명
PocketItemSendRecycleBoxByMoving=이동으로주머니아이템재활용상자전송
TentItemSendRecycleBoxByMoving=이동으로텐트아이템재활용상자전송
PknTalkLastNoCandyFlag=파크닌마지막사탕없음대화플래그
AddHowtoBookMydesignPro2=내디자인프로2하우투북추가
UnlockMydesignPro2=내디자인프로2언락
ExplainMydesignPro2=내디자인프로2설명
RcoMachineExplainMydesignPro2=알코기계내디자인프로2설명
NotBuilt2PMyHomeAfterMoving=이동후2P내집건설안함
HarvestProgress=수확진행
PknGiveLollipopCount=파크닌롤리팝줌횟수
TapSelWhereAreHere=탭여기어디선택
PknTalkLastNotGetFlag=파크닌마지막획득안함대화플래그
PknLastGiveCandyFlag=파크닌마지막사탕줌플래그
PknCompItemCandyFlag=파크닌완성아이템사탕플래그
PknCompItemLollipopFlag=파크닌완성아이템롤리팝플래그
PknPumpkingLookChatFlag=파크닌호박킹보기채팅플래그
Mobile1stBoot_Camera_UnlockKeyGuideOff=모바일첫부팅_카메라언락키가이드끄기
GetHalloweenRobe=할로윈로브획득
GetHalloweenMask=할로윈마스크획득
PknSendLetterFlag=파크닌편지전송플래그
PlayerMovingwithNoBelongings=소지품없이플레이어이동
NpcGiveCandyCount=NPC사탕줌횟수
GetHalloweenGarlandRecipe=할로윈가랜드레시피획득
GetHalloweenTableSettingRecipe=할로윈테이블세팅레시피획득
NpcTalkLastNotGetFlag=NPC마지막획득안함대화플래그
EnabledEmoticonIrregular=불규칙이모티콘활성화
CanGetMileTicketTrialForMoving=이동용마일티켓트라이얼획득가능
PlayerMovingOrderHouseBuilt=플레이어이동주문집건설
PlayerMovingOrderChangeHouseDesign=플레이어이동주문집디자인변경
PlayerMovingOrderHouseMoveInIsland=플레이어이동주문섬으로집이동
PlayerMovingAfterHouseRemodel=집리모델후플레이어이동
PlayerMovingAfterLoanFinish=대출완료후플레이어이동
TapUnlockFavorite=탭즐겨찾기언락
LastPlayHalloweenYear=마지막할로윈플레이년도
PlayerMovingDefaultHouseHasBasement=플레이어이동기본집지하실있음
PlayerMovingEnable=플레이어이동활성화
RemakeWithRcoOfficeBeforeWS=WS전알코오피스와리메이크
RemakeWithRcoTentBeforeWS=WS전알코텐트와리메이크
IslandCreaterUnlockMoving=섬크리에이터이동언락
AnnounceHalloween=할로윈공지
AnnounceHarvest=수확공지
MilageSendLetterFlag=마일리지편지전송플래그
NpcHalloweenGetMirrorFlag=NPC할로윈거울획득플래그
NpcHalloweenCandyHelpFlag=NPC할로윈사탕도움플래그
PlayerMovingWithEmoticonUI=이모티콘UI와플레이어이동
AddHairStyle4=헤어스타일4추가
PknGetItem=파크닌아이템획득
XctGetRewardThisIsland=엑스크트이섬보상획득
HarvestHQDish1P=수확고급요리1P
HarvestHQDish2P=수확고급요리2P
HarvestHQDish3P=수확고급요리3P
HarvestHQDish4P=수확고급요리4P
TukTalkFirst=투크첫대화
HarvestTalkAboutNextDishProgress=수확다음요리진행대화
TapUnlockLeaveTap=탭떠나기탭언락
HarvestKeepReward=수확보상보관
RewindDays=되감기일수
TukTalkBeforeEvent=투크이벤트전대화
TukTalkAfterEvent=투크이벤트후대화
AnnounceBeforeHarvest=수확전공지
PasswordIsOld=비밀번호가오래됨
FishExchangeLoseCount=물고기교환패배횟수
ReiTalkFirst=레이첫대화
ReiGetReward1=레이보상1획득
ReiGetReward2=레이보상2획득
ReiGetReward3=레이보상3획득
ReiStartQuest1=레이퀘스트1시작
ReiStartQuest2=레이퀘스트2시작
ReiFinishQuest1=레이퀘스트1완료
AnnouncePreChristmas=크리스마스전공지
SantaMissionNpcIndex1=산타미션NPC인덱스1
SantaMissionNpcIndex2=산타미션NPC인덱스2
SantaMissionNpcIndex3=산타미션NPC인덱스3
ReceiveLeaveTapLetter=떠나기탭편지수신
RcmExplainToy=알크장난감설명
PckTalkTodayFlag=피크오늘대화플래그
ChristmasWreathGetYear=크리스마스화환획득년도
TukSecretRewardType=투크비밀보상타입
TapUpdatedDreamFirstTalk=탭업데이트된꿈첫대화
SzaChristmasOrnament=사자크리스마스장식
CheckHarvestFtrInStore=상점에서수확가구체크
ChristmasPresentYear=크리스마스선물년도
InputApproachBanCount=입력접근금지횟수
PckLookChatFlag=피크보기채팅플래그
TukCancel1stRequest=투크첫요청취소
ChristmasWrappingGiftFlag=크리스마스선물포장플래그
HarvestRefuseGiveHQFood1=수확고급음식1거절
HarvestRefuseGiveHQFood2=수확고급음식2거절
HarvestRefuseGiveHQFood3=수확고급음식3거절
HarvestRefuseGiveHQFood4=수확고급음식4거절
HarvestGetHint1=수확힌트1획득
HarvestGetHint2=수확힌트2획득
HarvestGetHint3=수확힌트3획득
HarvestGetHint4=수확힌트4획득
ChristmasWrappingPresentFlag=크리스마스선물포장플래그
PckRecipeFlag=피크레시피플래그
RcoStorageExpansionReserved=알코보관확장예약
RcoStorageExpansionLevel=알코보관확장레벨
PlayerMovingReservedStorageExpand=플레이어이동예약보관확장
MailSend_NoticeStorageExpansion=보관확장공지메일전송
RcoStandbyNoticeStorageExpansion=알코보관확장공지대기
ChristmasWreathNoGetFlag=크리스마스화환획득안함플래그
PckGetItem=피크아이템획득
GetCarnivalLight=카니발조명획득
GetCarnivalFoodStand=카니발음식점획득
GetCarnivalstage=카니발무대획득
GetCarnivalConfettiMachine=카니발꽃가루기계획득
GetCarnivalPercussion=카니발타악기획득
GetCarnivalBalloonLight=카니발풍선조명획득
GetCarnivalUmbrellas=카니발우산획득
GetCarnivalFlag=카니발깃발획득
GetCarnivalGarland=카니발가랜드획득
GetCarnivalFloat=카니발플로트획득
PckGiveFurnitureCount=피크가구줌횟수
SloExplainPumpkinColorFlag=슬로호박색상설명플래그
SloExplainAddPumpkinFlag=슬로호박추가설명플래그
TukSecretRewardType3rd=투크비밀보상타입3번째
PckTalkBeforeFlag=피크이전대화플래그
SendNNPCConversationPlayReport=NNPC대화플레이리포트전송
MainmenuMydesignShowcase=메인메뉴내디자인쇼케이스
ChristmasPrevPresentItemType=크리스마스이전선물아이템타입
ValentineLetterFlag=발렌타인편지플래그
AnnounceChristmasEve=크리스마스이브공지
GetCarnivalFurniture=카니발가구획득
LastPlayValentineYear=마지막발렌타인플레이년도
PckRecipeTalkFlag=피크레시피대화플래그
Mobile1stBoot_MydesignShowcase=모바일첫부팅_내디자인쇼케이스
MydesignExchangeTalkAboutMobile=내디자인교환모바일대화
BuyReactionBook17=반응책17구매
GetCarnivalFurnitureRed=카니발가구빨강획득
GetCarnivalFurnitureBlue=카니발가구파랑획득
GetCarnivalFurnitureGreen=카니발가구초록획득
GetCarnivalFurniturePurple=카니발가구보라획득
GetCarnivalFurnitureRainbow=카니발가구무지개획득
PckColorLotteryFlag=피크색상복권플래그
RcmChkReactionBook=추천반응책확인
RcmChkCarnivalFtr=추천카니발가구확인
AnnounceCarnival=카니발공지
ShootDownShamrockRecipeBalloon=샴락레시피풍선쏘기
MailSendFlag_ReceiveAnniversaryItem=기념품수신메일전송플래그
AOC_EventFlag_002=AOC이벤트플래그002
UnlockSanrioCollaboPoster=산리오콜라보포스터해금
UnlockSanrioCollaboPoster2=산리오콜라보포스터2해금
UnlockSanrioCollaboPoster3=산리오콜라보포스터3해금
UnlockSanrioCollaboPoster4=산리오콜라보포스터4해금
UnlockSanrioCollaboPoster5=산리오콜라보포스터5해금
UnlockSanrioCollaboPoster6=산리오콜라보포스터6해금
AnnounceEaster=부활절공지
AnnounceEasterReady=부활절준비공지
AnnounceJuneBride=6월신부공지
PynEvent_SendMailThisYear=파인이벤트_올해메일전송
OwlArtStampRally1=부엉이미술스탬프랠리1
OwlArtStampRally2=부엉이미술스탬프랠리2
OwlArtStampRally3=부엉이미술스탬프랠리3
OwlStampGotArtReward=부엉이스탬프미술보상획득
OwlStampGotArt=부엉이스탬프미술획득
OwlArtUnfinished=부엉이미술미완성
UnlockSanrioCollabo=산리오콜라보해금
UnlockSanrioCollabo2=산리오콜라보2해금
UnlockSanrioCollabo3=산리오콜라보3해금
UnlockSanrioCollabo4=산리오콜라보4해금
UnlockSanrioCollabo5=산리오콜라보5해금
UnlockSanrioCollabo6=산리오콜라보6해금
OwlClearCount=부엉이클리어횟수
XctGetRewardSec=엑스트보상초획득
OwlStampPlayedThisYear=올해부엉이스탬프플레이
OwlStampPlayedThisYear2=올해부엉이스탬프플레이2
OwlStampPlayedThisYear3=올해부엉이스탬프플레이3
OwlStampPlayedThisYear4=올해부엉이스탬프플레이4
AlpJuneBrideNotGetLoveCrystalFrag=알프6월신부사랑크리스탈조각미획득
AlwJuneBrideExchangeTalkFlag=알우6월신부교환대화플래그
LastPlayMuseumYear=마지막박물관플레이년도
GetMayDayTicketFirst=메이데이티켓첫획득
RcoHeardAboutMayDayTravelTicket=르코메이데이여행티켓이야기듣기
XctGetRewardPast=엑스트과거보상획득
FoxTalk2020FireworksFlag=여우2020불꽃놀이대화플래그
FoxTalkIceCandyTodayFlag=여우오늘아이스캔디대화플래그
FoxTalkTapiocaTodayFlag=여우오늘타피오카대화플래그
AlwJuneBrideNoRemake1stFlag=알우6월신부재제작안함첫플래그
AnnounceHalloween2=할로윈2공지
FoxTalkFireworksFoodFlag=여우불꽃놀이음식대화플래그
AnnounceHalloween2Ready=할로윈2준비공지
FoxFirstTalkTodayFireworksFlag=여우오늘불꽃놀이첫대화플래그
LastPlayFireWorksFestival=마지막불꽃축제플레이
TodayCreateVillage=오늘마을생성
TodayPlayerEmigrate=오늘플레이어이주
TkkFirstLive=티케이케이첫라이브
FinishiPC1Prologue=PC1프롤로그완료
IsMovingConsultationToPlayer=플레이어에게이주상담중
EnableMarketBuild=시장건설활성화
ValidateVillageSave=마을저장검증
FreeEChatTimes=무료E채팅횟수
FreeFChatTimes=무료F채팅횟수
RandomKey=랜덤키
DoneMuseumConstruction=박물관건설완료
Prologue4BuiltPlayer=프롤로그4플레이어건설
Plorogue4BuiltMuseum=프롤로그4박물관건설
Prologue4BuiltShop=프롤로그4상점건설
Prologue4BuiltNpcAN=프롤로그4NPCAN건설
Prologue4BuiltNpcHA=프롤로그4NPCHA건설
TodayStartTown1P=오늘마을시작1P
ShopItemSet=상점아이템세트
VillageExtensionLevel2=마을확장레벨2
RcmGotSignboard=추천간판획득
InstalledMarketTentSign=시장텐트간판설치
SandBankDisable=모래은행비활성화
MarketRemodelingFlag1=시장리모델링플래그1
MarketOpen1stDay1=시장첫개장일1
SpotPrologueTimes=스팟프롤로그횟수
PlazaDonationMoney=광장기부금
PlazaDonationMaterial=광장기부재료
PlazaDonationFinish=광장기부완료
EventPlazaBuilt=이벤트광장건설
SzaGotGyroid=스자가이로이드획득
PlazaGyroidBuilt=광장가이로이드건설
MuseumGrowupEnable1=박물관성장활성화1
MuseumConstruction1=박물관건설1
Museum2Built=박물관2건설
Museum2BuiltToday=오늘박물관2건설
InsectNetHostCatchNumResult=곤충채집네트호스트결과
GlobalEventAvailable=글로벌이벤트사용가능
InsectFesFinished=곤충축제완료
MarketRemodelingFlag2=시장리모델링플래그2
MarketOpen1stDay2=시장첫개장일2
RcoMoveReservedKind=르코이주예약종류
QuestReserveStart=퀘스트예약시작
VillageDaysCount=마을일수카운트
PeddlingAvailableSlo=슬로행상사용가능
MarketBuilt=시장건설
PeddingAvailableBoa=보아행상사용가능
MarketConstruction1=시장건설1
MarketConstruction2=시장건설2
FirstKabuBuy=첫카부구매
FirstKabuPattern=첫카부패턴
FoxArtStockCount=여우미술재고수
EventPlazaBuiltToday=오늘이벤트광장건설
CountNnpcHouseSpaceSet=NNPC집공간세트카운트
GlobalEventReady=글로벌이벤트준비
BirthdayBbsVariation1=생일게시판변형1
EnableBuildTownOffice=마을사무소건설활성화
BuiltTownOffice=마을사무소건설
BuiltTownOfficeToday=오늘마을사무소건설
StartBuildingTownOffice=마을사무소건설시작
SzaDonatedItemType=스자기부아이템타입
SzaDonatedItemCount=스자기부아이템수
IsNpcIncreased=NPC증가여부
MuseumBuilt=박물관건설
TailorBuilt=재단사건설
IslandKanaType=섬가나타입
TodayGlobalEventId=오늘글로벌이벤트ID
TodayRegionEventId=오늘지역이벤트ID
NoncompliantRegionCode=비준수지역코드
GstTalkAnyone=게스트누구와대화
OwlFoundFossil=부엉이화석발견
MarketSellRecipeScoopStick=시장레시피스쿱스틱판매
TailorConstruction1=재단사건설1
FishFesFinished=물고기축제완료
HghStayMarket=하이그시장체류
EnableHghStayField=하이그체류필드활성화
EnableTailorBuild=재단사건설활성화
TailorReserved=재단사예약
TailorGetHousingkit=재단사주택키트획득
ReportedTaiorReserve=재단사예약보고
CountTailorBuild=재단사건설카운트
NNpcPhoneColorChangeCounter=NNPC전화색상변경카운터
RcoEnableBuyHousingKit=르코주택키트구매활성화
OpeningSeqBGMChangeCounter=오프닝시퀀스BGM변경카운터
JohnnySitUpFlag=조니앉기플래그
AllowNpcInterestActivity=NPC관심활동허용
RcoBuildCampsiteOngoing=르코캠프사이트건설진행중
RcoBuildCampsiteComplete=르코캠프사이트건설완료
RcoMeetFirstVisitorRequest=르코첫방문자만남요청
RcoMeetFirstVisitorOngoing=르코첫방문자만남진행중
RcoMeetFirstVisitorComplete=르코첫방문자만남완료
RcoBuildFirstVisitorsHousingKitOngoing=르코첫방문자주택키트건설진행중
RcoBuildFirstVisitorsHousingKitComplete=르코첫방문자주택키트건설완료
DonationAmountForMuseum=박물관기부금액
OfficeConstruction1=사무소건설1
JohnnyTalkAnyPlayerFlag=조니누구든플레이어대화플래그
TkkReturn=티케이케이귀환
FlightBalloonEnable=비행풍선활성화
ConfirmedFruit=확인된과일
RctInTent=텐트안의르크
GstAppearField=게스트출현필드
MuseumTentBuiltToday=오늘박물관텐트건설
TailorBuiltToday=오늘재단사건설
VillageExtensionLevel3=마을확장레벨3
RcoBuildBridgeSlopeStatusCounter=르코다리경사건설상태카운터
RcoMoveReservedAnyone=르코이주예약누구든
HgcVisitFlagForTailor=하이그재단사방문플래그
RcoDeleteBridgeSlopeReservedAnyone=르코다리경사삭제예약누구든
RcoBuildBridgeSlopeSelector=르코다리경사건설선택자
RcoIslandRevitilizationRefuse=르코섬활성화거부
MessageBottleAvailable=메시지병사용가능
ImmQ_A_GetHousing=이민퀘스트A주택획득
ImmQ_B_GetHousing=이민퀘스트B주택획득
ImmQ_C_GetHousing=이민퀘스트C주택획득
ImmQ_A_SetHousing=이민퀘스트A주택설정
ImmQ_B_SetHousing=이민퀘스트B주택설정
ImmQ_C_SetHousing=이민퀘스트C주택설정
ImmQ_A_Interior1Donate=이민퀘스트A인테리어1기부
ImmQ_B_Interior1Donate=이민퀘스트B인테리어1기부
ImmQ_C_Interior1Donate=이민퀘스트C인테리어1기부
ImmQ_A_Interior2Donate=이민퀘스트A인테리어2기부
ImmQ_B_Interior2Donate=이민퀘스트B인테리어2기부
ImmQ_C_Interior2Donate=이민퀘스트C인테리어2기부
ImmQ_A_Interior3Donate=이민퀘스트A인테리어3기부
ImmQ_B_Interior3Donate=이민퀘스트B인테리어3기부
ImmQ_C_Interior3Donate=이민퀘스트C인테리어3기부
ImmQ_A_Outdoor1Set=이민퀘스트A야외1설정
ImmQ_B_Outdoor1Set=이민퀘스트B야외1설정
ImmQ_C_Outdoor1Set=이민퀘스트C야외1설정
ImmQ_A_Outdoor2Set=이민퀘스트A야외2설정
ImmQ_B_Outdoor2Set=이민퀘스트B야외2설정
ImmQ_C_Outdoor2Set=이민퀘스트C야외2설정
ImmQ_A_Outdoor3Set=이민퀘스트A야외3설정
ImmQ_B_Outdoor3Set=이민퀘스트B야외3설정
ImmQ_C_Outdoor3Set=이민퀘스트C야외3설정
ImmQ_A_Complete=이민퀘스트A완료
ImmQ_B_Complete=이민퀘스트B완료
ImmQ_C_Complete=이민퀘스트C완료
ImmQ_A_Invited=이민퀘스트A초대
ImmQ_B_Invited=이민퀘스트B초대
ImmQ_C_Invited=이민퀘스트C초대
RcmImmQuestOpen=추천이민퀘스트오픈
RcmImmQuestRunning=추천이민퀘스트실행중
RcmImmQuestComplete=추천이민퀘스트완료
JohnnyRequirePartsNum=조니필요부품수
ImmQ_A_InteriorDonateNow=이민퀘스트A인테리어지금기부
ImmQ_B_InteriorDonateNow=이민퀘스트B인테리어지금기부
ImmQ_C_InteriorDonateNow=이민퀘스트C인테리어지금기부
RcoRemoveBridgeSlopeSelector=르코다리경사제거선택자
CeremonySlopeUnitX=의식경사유닛X
CeremonySlopeUnitZ=의식경사유닛Z
RcoNoticeBuildInfomationOffice=르코건설정보사무소공지
CampSiteBuilt=캠프사이트건설
RcoDeleteBridgeSlopeBuildPlayer=르코다리경사건설플레이어삭제
VisitorPrayStarToday=오늘방문자별기도
AmiiboCampSiteCall=아미보캠프사이트호출
ImmQ_SetBridge=이민퀘스트다리설정
CampQuestInProgress=캠프퀘스트진행중
CampQuestClear=캠프퀘스트클리어
SzaTaled1stTimeAnyPlayer=스자누구든첫대화
CeremonyBridgeUnitX=의식다리유닛X
CeremonyBridgeUnitZ=의식다리유닛Z
CeremonyBuildCampSite=의식캠프사이트건설
CeremonyBuildTailor=의식재단사건설
CeremonyBuildBridge=의식다리건설
CeremonyBuildSlope=의식경사건설
IslandDevQuestRunning=섬개발퀘스트실행중
IslandDevQuestComplete=섬개발퀘스트완료
CountTailorAfterBuild=재단사건설후카운트
CountMuseumAfterBuild=박물관건설후카운트
CountMarket1AfterBuild=시장1건설후카운트
CountMarket2AfterBuild=시장2건설후카운트
CountOfficeAfterBuild=사무소건설후카운트
CountFirstBridgeAfterBuild=첫다리건설후카운트
CountFirstSlopeAfterBuild=첫경사건설후카운트
IslandEvaluationUnlock=섬평가해금
IslandEvaluationClearTkkLive=섬평가티케이케이라이브클리어
HaveHousingKitCount=주택키트보유수
BridgeBuilt=다리건설
SlopeBuilt=경사건설
BeyRequireFishSize=베이필요물고기크기
TanuportAmiiboUnlock=타누포트아미보해금
SpnVisitMainField=스팬메인필드방문
ChangePlazaFtrToNormal=광장가구일반으로변경
SetPrologueBonfire=프롤로그모닥불설정
ImmQ_A_OutdoorPattern=이민퀘스트A야외패턴
ImmQ_B_OutdoorPattern=이민퀘스트B야외패턴
ImmQ_C_OutdoorPattern=이민퀘스트C야외패턴
TkkFirstLiveReserved=티케이케이첫라이브예약
BirthdayBbsVariation2=생일게시판변형2
AllowNpcGroupActivity=NPC그룹활동허용
TanuportAmiiboCampUnlock=타누포트아미보캠프해금
PickedUpMessageBottle=메시지병줍기
CountAppE_RepTalk=앱E대표대화카운트
FlwLilyGrowCounter=꽃백합성장카운터
FlwLilyFirstGrow=꽃백합첫성장
CampFirstCamperVisit=캠프첫캠퍼방문
RcmShopMaterial_Wood=추천상점재료_나무
RcmShopMaterial_HardWood=추천상점재료_단단한나무
RcmShopMaterial_SoftWood=추천상점재료_부드러운나무
RcmShopMaterial_Iron=추천상점재료_철
RcmShopMaterialComplete=추천상점재료완료
ReportFirstCamperAboutSetHousing=첫캠퍼주택설정보고
RcoRcmTalkingAboutStoreMaterial=르코추천상점재료대화
PAnnounceRcoCalling=P알림르코호출
PAnnounceCeremony1st=P알림의식첫번째
PAnnounceCeremony1stToday=오늘P알림의식첫번째
CampSiteBuiltToday=오늘캠프사이트건설
CountCampSiteAfterBuild=캠프사이트건설후카운트
IslandLocalFruitApple=섬지역과일사과
IslandLocalFruitOrange=섬지역과일오렌지
IslandLocalFruitPear=섬지역과일배
IslandLocalFruitPeach=섬지역과일복숭아
IslandLocalFruitCherry=섬지역과일체리
PAnnounceKkProject=P알림케이케이프로젝트
TownNewsHeardEventStarted=마을뉴스이벤트시작듣기
SzaIslandEvaluationBeforeLife=스자섬평가생활이전
SzaIslandEvaluationBeforeNatural=스자섬평가자연이전
FishNetHostCatchNumResult=물고기채집네트호스트결과
SzaIslandEvaluationBeforeDevelopment=스자섬평가개발이전
SzaIslandEvaluationTodayRankUpdate=스자섬평가오늘순위업데이트
SzaIslandEvaluationImprovementLifeToday=스자섬평가생활개선오늘
SzaIslandEvaluationImprovementNaturalToday=스자섬평가자연개선오늘
SzaIslandEvaluationImprovementDevelopToday=스자섬평가개발개선오늘
AppE_WelcomoMigrants_AN=앱E이민자환영_AN
AppE_WelcomoMigrants_HA=앱E이민자환영_HA
TkkFirstLiveSubPlayer=티케이케이첫라이브서브플레이어
PortableRadioControl=휴대용라디오제어
Market2Built=시장2건설
OwlTentExplainFor1P=부엉이텐트1P설명
MuseumConstructionToday=오늘박물관건설
ShopUnlockAxe=상점도끼해금
FinishMuseumPreparation1stDay=박물관준비첫날완료
MushroomProbability=버섯확률
NNpcContractProbablityAddPoint=NNPC계약확률추가포인트
TkkFirstLiveEnable=티케이케이첫라이브활성화
ImmQClearNextDay=이민퀘스트다음날클리어
TodayImmQNotClear=오늘이민퀘스트미클리어
NpcDIYScheduleSet=NPCDIY스케줄설정
PAnnounceToday=오늘P알림
AirportOpen=공항개방
AnyGlobalEventFinished=모든글로벌이벤트완료
LostPropertyFound=분실물발견
MuseumFossilComplete=박물관화석완료
InduceInMysteriTourIslandToday=오늘미스터리투어섬유도
Tutorial1PTentLightON=튜토리얼1P텐트조명켜기
CatchInsectFesGetTotalNum=곤충축제채집총수획득
CatchFishFesGetTotalNum=물고기축제채집총수획득
JohnnyQuestFinishFlagIsland=조니퀘스트완료플래그섬
CampRandomSelectMoveOutNpc=캠프랜덤이주NPC선택
CampFireRemoved=캠프모닥불제거
UnlockEaster=부활절해금
MuseumConstruction2=박물관건설2
MuseumGrowupEnable2=박물관성장활성화2
OwlWantsPainting=부엉이그림원함
CampTodaySelectMoveOutNpc=오늘캠프이주NPC선택
Museum3Built=박물관3건설
Museum3BuiltToday=오늘박물관3건설
CountMuseum2AfterBuild=박물관2건설후카운트
Museum2ConstructionToday=오늘박물관2건설
GrowUpAfterPatch1_1=패치1_1후성장
GrowUpAfterPatch1_2=패치1_2후성장
GrowUpAfterPatch1_3=패치1_3후성장
GrowUpAfterPatch1_4=패치1_4후성장
EarthdaySloFirstVisit=지구의날슬로첫방문
OwlFoundDiveFish=부엉이잠수물고기발견
SloPeddlerPurchaceToday=오늘슬로행상구매
FoxPreVisitToday=오늘여우사전방문
AnyPlayerHouseBuilt=누구든플레이어집건설
MuseumFishStampRackLotID1=박물관물고기스탬프랙로트ID1
MuseumFishStampRackLotID2=박물관물고기스탬프랙로트ID2
MuseumFishStampRackLotID3=박물관물고기스탬프랙로트ID3
MuseumInsectStampRackLotID1=박물관곤충스탬프랙로트ID1
MuseumInsectStampRackLotID2=박물관곤충스탬프랙로트ID2
MuseumInsectStampRackLotID3=박물관곤충스탬프랙로트ID3
MuseumFossilStampRackLotID1=박물관화석스탬프랙로트ID1
MuseumFossilStampRackLotID2=박물관화석스탬프랙로트ID2
MuseumFossilStampRackLotID3=박물관화석스탬프랙로트ID3
AOC_EventFlag_000=AOC이벤트플래그000
AOC_EventFlag_001=AOC이벤트플래그001
FoxPreVisitReserve=여우사전방문예약
FoxMovedToMarket=여우시장으로이동
FoxAndShipReserve=여우와배예약
BCAT_EventFlag_002=BCAT이벤트플래그002
BCAT_EventFlag_004=BCAT이벤트플래그004
BCAT_EventFlag_001=BCAT이벤트플래그001
BCAT_EventFlag_003=BCAT이벤트플래그003
FoxPreVisit1Today=오늘여우사전방문1
FoxPreVisit2Today=오늘여우사전방문2
EarthdaySloFirstVisitToday=오늘지구의날슬로첫방문
IsDreamingBed=꿈꾸는침대
UnlockJuneBrideSeq=6월신부시퀀스해금
RandomKey1=랜덤키1
RandomKey2=랜덤키2
RandomKey3=랜덤키3
RandomKey4=랜덤키4
FoxPreVisitAlreadyBuyToday=오늘여우사전방문이미구매
RcoHasResolvedMoveKitBug=르코이동키트버그해결
TapDreamEnable=탭꿈활성화
GulBVisitEnable=굴B방문활성화
FireworksAddBbsYear=불꽃놀이게시판추가년도
EnableMyDream=내꿈활성화
JohnnyInvisible=조니투명
DreamUploadPlayerHaveCreaterID=꿈업로드플레이어크리에이터ID보유
DiveFishNetHostCatchNumResult=잠수물고기네트호스트채집결과
HalloweenSloVisitYear=할로윈슬로방문년도
HalloweenSloVisitToday=오늘할로윈슬로방문
GrowUpAfterPatch1_5=패치1_5후성장
NeedUpdatePassword=비밀번호업데이트필요
IsHalloweenLessThanThreeDays=할로윈3일미만
GrowUpAfterPatch1_6=패치1_6후성장
IslandProducedByPlayerMoving=플레이어이동으로생성된섬
EventObjFlag0=이벤트오브젝트플래그0
PlayerMovingEnableShopMaterialCollect=플레이어이동상점재료수집활성화
SecondPublicAnnouncement=두번째공식발표
HarvestAfterTerm=기간후수확
FinishTreasureQuestByRollback=롤백으로보물퀘스트완료
HarvestHQDish1Island=수확고급요리1섬
HarvestHQDish2Island=수확고급요리2섬
HarvestHQDish3Island=수확고급요리3섬
HarvestHQDish4Island=수확고급요리4섬
IsDisclosedMyDream=내꿈공개여부
HarvestTukIngredient2_2=수확투크재료2_2
HarvestTukIngredient3_1=수확투크재료3_1
HarvestTukIngredient3_2=수확투크재료3_2
HarvestTukIngredient4_2=수확투크재료4_2
HarvestTukHideIngredient2_1=수확투크숨김재료2_1
HarvestTukHideIngredient2_2=수확투크숨김재료2_2
ReputaionMyIsland=내섬평판
LastPlayXmasYear=마지막크리스마스플레이년도
ShopSelectChristmasFtr=상점크리스마스가구선택
IsUploadDisclosedMyDream=업로드내꿈공개여부
TkkFirstLiveNow=티케이케이첫라이브지금
ChristmasFtrFirstRound=크리스마스가구첫라운드
HarvestFestivalAddBbsYear=수확축제게시판추가년도
GrowUpAfterPatch1_7=패치1_7후성장
XmasEveAddBbsYear=크리스마스이브게시판추가년도
BCAT_EventFlag_005=BCAT이벤트플래그005
RandomKey5=랜덤키5
ShopSocksFlag=상점양말플래그
ShopHeartChocoSelect=상점하트초코선택
ShopHeartFlowerSelect=상점하트꽃선택
RandomKey6=랜덤키6
RandomKey7=랜덤키7
RandomKey8=랜덤키8
BCAT_EventFlag_006=BCAT이벤트플래그006
BCAT_EventFlag_007=BCAT이벤트플래그007
BCAT_EventFlag_008=BCAT이벤트플래그008
GrowUpAfterPatch1_8=패치1_8후성장
GrowUpAfterPatch1_9=패치1_9후성장
RandomKey9=랜덤키9
BCAT_EventFlag_009=BCAT이벤트플래그009
ValentineAddBbsYear=발렌타인게시판추가년도
CarnivalAddBbsYear=카니발게시판추가년도
CarnivalNpcFeatherColorDecided=카니발NPC깃털색상결정
CarnivalEventPlazaNpcWander=카니발이벤트광장NPC배회
BCAT_EventFlag_010=BCAT이벤트플래그010
RandomKey10=랜덤키10
BCAT_EventFlag_011=BCAT이벤트플래그011
RandomKey11=랜덤키11
MuseumArtStampRackLotID1=박물관미술스탬프랙로트ID1
MuseumArtStampRackLotID2=박물관미술스탬프랙로트ID2
MuseumArtStampRackLotID3=박물관미술스탬프랙로트ID3
EventObjFlag1=이벤트오브젝트플래그1
EventObjFlag2=이벤트오브젝트플래그2
GrowUpAfterPatch1_10=패치1_10후성장
GrowUpAfterPatch1_11=패치1_11후성장
BCAT_EventFlag_012=BCAT이벤트플래그012
RandomKey12=랜덤키12
MayDayAddBbsYear=메이데이게시판추가년도
EventObjFlag3=이벤트오브젝트플래그3
HalloweenAddBbsYear=할로윈게시판추가년도
ExistIllminations=조명존재
ExistSakura=벚꽃존재
ExistBanboo=대나무존재
ExistOak=참나무존재
ExistCedar=삼나무존재
NnpcHouseLoan=NNPC집대출
NnpcHouseBuildOk=NNPC집건설승인
NnpcHouseBuilt=NNPC집건설
CoordinateUpdate=좌표업데이트
Is3rdNpc=3번째NPC여부
MoveInCompletion=이주완료
LastFtrNum=마지막가구수
MoveRoomIndex=이동방인덱스
PlayerNamePhrase=플레이어이름구문
AbandonedHouse=버려진집
InputPhrase=입력구문
TalkLifeStart1P1st=1P첫생활시작대화
FromSettlerQuest=정착자퀘스트에서
ChangeFirstWall=첫벽변경
ChangeFirstFloor=첫바닥변경
GetFirstVillagerWallFtr1=첫주민벽가구1획득
GetFirstVillagerWallFtr2=첫주민벽가구2획득
UseAudioType=사용오디오타입
TalkTransitionTimes=대화전환횟수
FinishTalkTransition=대화전환완료
OutdoorCatnap=야외낮잠
ForceMoveOut=강제이주
EarlyOrLate=일찍또는늦게
ContinuousNormalDay=연속일반일
React1stNpcPresent=첫NPC선물반응
IsReFabricSmartPhone=재제작스마트폰여부
MarketBuildingSupport=시장건설지원
NnpcHouseBuiltToday=오늘NNPC집건설
AppE_Happen1st=앱E첫발생
AppE_GetItem1st=앱E첫아이템획득
AppE_Rep_HappenToday=오늘앱E대표발생
AppE_WelcomoMigrants=앱E이민자환영
AppE_WelcomeMigrantsToday=오늘앱E이민자환영
MoveInOrder=이주순서
EquipEasterWear=부활절의상착용
ForceMoveOutVillagerIndex=강제이주주민인덱스
DisplayJuneBridePresent=6월신부선물표시
ProgressDaysJuneBrideParty=6월신부파티진행일수
EnableConvTalkDaysCount=대화일수카운트활성화
WantIngredients=재료원함
BeforeGiveIngredients=재료주기전
BeforeWantIngredients=재료원하기전
XmasEveWakeUpMinute=크리스마스이브기상분
EquipChristmasWear=크리스마스의상착용
HarvestGiveHint1=수확힌트주기1
HarvestGiveHint2=수확힌트주기2
HarvestGiveHint3=수확힌트주기3
HarvestGiveHint4=수확힌트주기4
CarnivalFeatherColor=카니발깃털색상
DisplayValentinePresent=발렌타인선물표시
HarvestDemoEndWait=수확데모종료대기
WoreNewYearHat=새해모자착용
HarvestDemoStateNow=수확데모현재상태
WearItemLayer1LayoutLimit=착용아이템레이어1레이아웃제한
